{
  "a": 24,
  "z": 25,
  "e": 26,
  "r": 27,
  "t": 28,
  "y": 29,
  "u": 30,
  "i": 31,
  "o": 32,
  "p": 33,
  "dead_circumflex": 34,
  "dollar": 35,
  "Return" : 36,
  "q": 38,
  "s": 39,
  "d": 40,
  "f": 41,
  "g": 42,
  "h": 43,
  "j": 44,
  "k": 45,
  "l": 46,
  "m": 47,
  "ugrave": 48
}
